Europe
Europe — europe.pool.ntp.org
Austria — at.pool.ntp.org
Switzerland — ch.pool.ntp.org
Germany — de.pool.ntp.org
Denmark — dk.pool.ntp.org
Spain — es.pool.ntp.org
France — fr.pool.ntp.org
Italy — it.pool.ntp.org
Luxembourg — lu.pool.ntp.org
Netherlands — nl.pool.ntp.org
Norway — no.pool.ntp.org
Poland — pl.pool.ntp.org
Sweden — se.pool.ntp.org
Slovenia — si.pool.ntp.org
United Kingdom — uk.pool.ntp.org
Finland — fi.pool.ntp.org
Ireland — ie.pool.ntp.org
Russian Federation — ru.pool.ntp.org
Belgium — be.pool.ntp.org
Portugal — pt.pool.ntp.org
Greece — gr.pool.ntp.org
Hungary — hu.pool.ntp.org
Bulgaria — bg.pool.ntp.org
Romania — ro.pool.ntp.org
Czech Republic — cz.pool.ntp.org
Yugoslavia — yu.pool.ntp.org
Estonia — ee.pool.ntp.org
Belarus — by.pool.ntp.org
Slovakia — sk.pool.ntp.org
Ukraine — ua.pool.ntp.org
Lithuania — lt.pool.ntp.org
Macedonia — mk.pool.ntp.org
Moldova — md.pool.ntp.org
Latvia — lv.pool.ntp.org
Croatia — hr.pool.ntp.org
Republic of Serbia — rs.pool.ntp.org
Bosnia and Herzegovina — ba.pool.ntp.org
Armenia — am.pool.ntp.org
Iceland — is.pool.ntp.org
Liechtenstein — li.pool.ntp.org
Albania — al.pool.ntp.org
Republic of Montenegro — me.pool.ntp.org
Gibraltar — gi.pool.ntp.org
Azerbaijan — az.pool.ntp.org
Isle of Man — im.pool.ntp.org
Cyprus — cy.pool.ntp.org
Asia
Asia — asia.pool.ntp.org
Philippines — ph.pool.ntp.org 
Malaysia — my.pool.ntp.org
Turkey — tr.pool.ntp.org
Singapore — sg.pool.ntp.org
India — in.pool.ntp.org
Hong Kong — hk.pool.ntp.org
United Arab Emirates — ae.pool.ntp.org
Japan — jp.pool.ntp.org
Bangladesh — bd.pool.ntp.org
Israel — il.pool.ntp.org
Korea — kr.pool.ntp.org
Thailand — th.pool.ntp.org
Iran — ir.pool.ntp.org
Taiwan — tw.pool.ntp.org
China — cn.pool.ntp.org
Indonesia — id.pool.ntp.org
Vietnam — vn.pool.ntp.org
Pakistan — pk.pool.ntp.org
Oman — om.pool.ntp.org
Uzbekistan — uz.pool.ntp.org
Sri Lanka — lk.pool.ntp.org 
Kyrgyzstan — kg.pool.ntp.org
Cambodia — kh.pool.ntp.org
Qatar — qa.pool.ntp.org
Saudi Arabia — sa.pool.ntp.org
Iraq — iq.pool.ntp.org
Kazakhstan — kz.pool.ntp.org
Maldives — mv.pool.ntp.org
Kuwait — kw.pool.ntp.org
North America
North America — north-america.pool.ntp.org
Canada — ca.pool.ntp.org
United States — us.pool.ntp.org
Mexico — mx.pool.ntp.org
Guatemala — gt.pool.ntp.org
Panama — pa.pool.ntp.org
Bahamas — bs.pool.ntp.org
Costa Rica — cr.pool.ntp.org
El Salvador — sv.pool.ntp.org
Guam — gu.pool.ntp.org
Oceania
Oceania — oceania.pool.ntp.org
Australia — au.pool.ntp.org
New Zealand — nz.pool.ntp.org
New Caledonia — nc.pool.ntp.org
Vanuatu — vu.pool.ntp.org
South America
South America — south-america.pool.ntp.org
Brazil — br.pool.ntp.org
Chile — cl.pool.ntp.org
Argentina — ar.pool.ntp.org
Venezuela — ve.pool.ntp.org
Peru — pe.pool.ntp.org
Uruguay — uy.pool.ntp.org
Colombia — co.pool.ntp.org
Ecuador — ec.pool.ntp.org