Europe
Europe — europe.pool.ntp.org
Austria — at.pool.ntp.org
Switzerland — ch.pool.ntp.org
Germany — de.pool.ntp.org
Denmark — dk.pool.ntp.org
Spain — es.pool.ntp.org
France — fr.pool.ntp.org
Italy — it.pool.ntp.org
Luxembourg — lu.pool.ntp.org
Netherlands — nl.pool.ntp.org
Norway — no.pool.ntp.org
Poland — pl.pool.ntp.org
Sweden — se.pool.ntp.org
Slovenia — si.pool.ntp.org
United Kingdom — uk.pool.ntp.org
Finland — fi.pool.ntp.org
Ireland — ie.pool.ntp.org
Russian Federation — ru.pool.ntp.org
Belgium — be.pool.ntp.org
Portugal — pt.pool.ntp.org
Greece — gr.pool.ntp.org
Hungary — hu.pool.ntp.org
Bulgaria — bg.pool.ntp.org
Romania — ro.pool.ntp.org
Czech Republic — cz.pool.ntp.org
Yugoslavia — yu.pool.ntp.org
Estonia — ee.pool.ntp.org
Belarus — by.pool.ntp.org
Slovakia — sk.pool.ntp.org
Ukraine — ua.pool.ntp.org
Lithuania — lt.pool.ntp.org
Macedonia — mk.pool.ntp.org
Moldova — md.pool.ntp.org
Latvia — lv.pool.ntp.org
Croatia — hr.pool.ntp.org
Republic of Serbia — rs.pool.ntp.org
Bosnia and Herzegovina — ba.pool.ntp.org
Armenia — am.pool.ntp.org
Iceland — is.pool.ntp.org
Liechtenstein — li.pool.ntp.org
Albania — al.pool.ntp.org
Republic of Montenegro — me.pool.ntp.org
Gibraltar — gi.pool.ntp.org
Azerbaijan — az.pool.ntp.org
Isle of Man — im.pool.ntp.org
Cyprus — cy.pool.ntp.org
